111111111111111111111111111111111111111111111111111111111111
1000000010P1111111111111111111111111111111111111111111111111
100000000001111111111111111111111111111111111111111111111111
1110E0000001111111111111111111111111111111111111111111111111
1C0000000001111111111111111111111111111111111111111111111111
111111111111111111111111111111111111111111111111111111111111
