1111111111111111111111111111111111111111111
1C00000000000000000000C10000000000000000111
1000000000000000000000010000000000000000111
1000000000000000000000010000000000000000111
1000000000000000000000010000000000000000111
1000000000000000000000E10000000000000000111
1000000000000000000000010000000000000000111
1000000000000000000000010000000000000000111
1000000000000000000000010000000000000000111
1C000000000P0000000000C10000000000000000111
1111111111111111111111111111111111111111111